10.ox
.....o....
.....o....
..........
........oo
..........
..........
.ooo.o....
.oo......o
.o.......o
..o...ooo.
